AAAAAAAAAA
AAAAAAAAAA
AAAAAAAAAA
GAAAAAAAAA
GGGGGGGGGG
