AAAAAAAAAA
AAAAAAAAAA
AAAAAGAAAA
GAAAAGAAAA
GGGGGGGGGG
